##### #########
#   #       # #
### # ##### # #
#   #   #     #
# # ### ##### #
# #   #   # # #
# ####### # # #
#           # #
### ###########

